Subject: save a bundle on meds !
got a condition ?
if you require any of the medications below ,
save up to 80 % here :
http : / / www . munaju . info / 92 /
allergy : claritin - zyrtec
antibiotic : asacol - ceftin - cipro - tequin
anti depressant : celexa - effexor - paxil - prozac - remeron - zoloft
anxiety : buspar - valium - xanax
arthritis : arava - rheumatrex
blood pressure : altace - avapro - cardizem - cozaar - flomax - norvasc - plavix
bone and joint : fosamax
cancer : nolvadex - purinethol
cholesterol : lipitor - pravachol - zocor
diabetes : actos - avandia - glucophage
hair loss : propecia
headhache : imitrex
heart burn : aciphex
hepatitis b : epivir
herpes : neurontin
hiv : retrovir - sustiva - videx - viramune - zerit
muscle relaxant : soma
nausea : zofran
pain relief : bextra - celebrex - vioxx
seizures : lamictal
sexual health : cialis - viagra
skin : oxsoralen
sleep aid : ambien
smoking : zyban
upset stomach : nexium - prevacid - prilosec
weight loss : meridia
women ' s health : diflucan - evista
politics nauticacaesar metallic dgj
userl trumpetvenus tarzan pacers jamesl nimrod cougars
roxy hanson rusty
scubal medicalstingl valentin express
wanker carl jan
florida racerxgretchen skidoo happyday
horizon jkmfirst theking whitney paula shawn daddy
